1111111111111
100100010E001
10010100000C1
100C011111111
1P00110000C01
1111111111111