1111111111111
101000010C011
10101100010C1
100C011111111
1P10110000E01
1111111111111