1111111111111
100100010C001
10010100000C1
100C0111E1111
1P00110000C01
1111111111111